%%%%%%%%%%%%%%%%%%%%
%.o.%.   o   .%%.o.%
% % %.%%%%%%%%%% % %
%        GG      o %
%%%%%%%%.% %%%%%%%P%
%%%%%%%% o    .    %
%%%%%%%%%%%%%%%%%%%%
