%%%%%%%%%%%%%%%%%%%%
%. .%.       .%%. .%
% % %.%%%%%%%%%% % %
%        GG        %
%%%%%%%%.% %%%%%%%P%
%%%%%%%%      .    %
%%%%%%%%%%%%%%%%%%%%
