%%%%%%%%%%%%%%%%%%%%
%.   %.      .%   .%
% %% % %%  %% % %% %
% %     %  %.    % %
% %%%%%%%  %% %% % %
%       GGGG% %    %
% %    %%%%%% %  % %
% %    %    % %  % %
% %    % %%%% %  % %
% %           %  % %
% %% % %%%%%% % %% %
%.   %.  P   .%   .%
%%%%%%%%%%%%%%%%%%%%